11111111111111111111111111111
1P00000000C000000C00000000001
10111111101111111111110111N01
1000000C100000000000010001001
1011101C111011101111010001C01
1010001C100010100001010001001
1010111C101110101111011111001
101CCCCC1000C0100000N00100111
101C111C101110101110101101001
101CCCCC10000N000000000001001
10111111111111111111110111001
10000N0000000C00000000010C111
10111011101110111011110001001
10100000100C00100000110001001
10101111101111101110110001001
101000000N0000000000000001001
10101111111111111111111N010N1
10N00000000000000000000C000E1
11111111111111111111111111111