11111111111111111111111111111
1000000000C000000C00000000001
10111111101111111111110111N01
1000000C100000000000010001001
1011101C111011101111010001CN1
1010001C100010100001010001001
1010111C101110101111011111N01
101CCCCC1000C0100000N1CCCN001
101C111C1011101011101011000N1
101CCCCC10000N000000000011001
10111111111111111111110111001
10CCCN0000000C00000000010C111
10111011101110111011110N01001
1P100000100C00100000110001C01
1010111110111110111011N0N1001
101000000N0000000000000N01001
10101111110111111111111N010N1
10N00000000000000000000C000E1
11111111111111111111111111111