11111111111111111111111111111111
1P00000000C000000C00000000000001
10111111101111111111111111111101
101000000000000000000000100C1001
10100CC0CCCC0CCCC0CCCCC010NC1CN1
1010C0C0000C0000C0000C00100N1001
101C00C0CCCC0CCCC00CCC0011011N01
101000C0000C0000C00C00001NCN0001
101000C0CCCC0CCCC0C0000011000N11
10100000000000000000000011011001
10111111111111111111110110011001
10CCCN0000000C00000000000010C111
10111011101110111011110111N01C01
10100000100C00100000110011100101
1010111110111110111011N0N0001101
101000000N0000000000000000N01001
10101111110111111111111N000010N1
10N00000000000000000000C000000E1
11111111111111111111111111111111