111111111111111111111111111111
1P00000000C000000C000000000011
101111111011111111111101110011
100000001000000000000100010011
101110101110111011110100010011
101000101000101000010100010011
101011101011101011110111110011
101000001000C01000000001001111
101011101011101011101011010011
101000001000000000000000010011
101111111111111111111101110011
100000000000C00000010001001111
101110111011101110111100010011
101000001000001000001100010011
101011111011111011101100010011
101000000000000000000000010011
101011111111111111111110010011
10000000000000000000000C000E11
111111111111111111111111111111