111111
1PE011
10CCC1
100001
100001
100001
100001
111111