11111111111111111111111111111
1000000000C000000C00000000001
10111111111111111111110111001
10000000100000000000010001001
10111010111011101111010001001
10100010100010100001010001001
10101110101110101111011111001
101000001000C0100000000100111
10101110101110101110101101001
10100000100000000000000001001
10111111111111111111110111001
100000000000C0000000000100111
10111011101110111011110001001
10100000100000100000110001C01
10101111101111101110110001001
10100000000000000000000001001
10101111111111111111111001111
1P000000000000000000000C000E1
11111111111111111111111111111